7 7
2 0
3 6
#######
##.##.#
....#.#
###.#..
#...###
#.#...#
#######