21 39
1 0
19 38
#######################################
......#.......##...#....#.#.#.#.#.##.##
#.###########....#...##.......#.......#
#......#...############.####.####.#.#.#
##.###.#.#.#........###.##.#.#..#.....#
##.###.#.#.#.######.###.##.#.#.##.###.#
#...##.....#.#.#.##.###.##.#.#....#.#.#
##.#########.#..........##.#.####.#.#.#
##........##.#############.#......#.#.#
#########.##.#.......#####.#.######.#.#
#......##.##.#.#####.....#.#.##.#.#.#.#
#.#.##.##.##...#...#.###.#.#.#........#
#....#.##.#######.##.#.#.#.#.##########
##.###.##..............#...#....#.....#
####.#.#####################.##.##.##.#
###.....#....#...#...........##....#..#
#######.#.##.#.#.#.####################
#...###...##...#...#....##.....#......#
#.#.#...############.##.##.#.#.###.##.#
#.....#......................#......#..
#######################################